# ###########################################################
#         #   # #       #     #     # # #     # #           #
# ##### # # ### ####### # ### ##### # # ### # # ##### ### ###
# # #   # # #     #   # # #     #   # # #   # # #     # #   #
# # ### ### ### ### ### # # ####### # # # # # # # ##### # ###
# #     #   #         # # # # #         # # #   #       #   #
### # ##### # ######### ### # # # # ####### ### ##### #######
#   # #                         # # #   #     #   #       # #
# ### # # # ##### ######### ##### ##### ### ##### ##### # # #
#   #   # # #   # #       # #           #     # # #   # # # #
# ### ####### # # ####### ### ####### # # # ### ##### ### # #
# #         # #           # #     #   #   #         #   # # #
# # # # ####### ### # # ### # ####### ### # # ####### ### # #
# # # # #   #     # # #   #   #   #   #   # #   #         # #
##### ### # ### # # ### ######### ### # ############# # ### #
# #     # # #   # #   # # #         # #   #       # # #     #
# # ##### ##### ### ##### # # ### ##### ### ####### # # #####
#       #       #       #   # #   #                 # # #   #
### ##### # # ### ### # ##### ######### ##### # ### # ##### #
# # #   # # #   #   # # #         #   # # # # # #   # #   # #
# ### # ######### # ### # ### # ### ##### # # ####### # # # #
#   # #     #   # # #     # # # # #   # # #     #   #   #   #
# ##### ##### ### # ##### # # # # ### # # # ### ### # ### # #
#           #     #     #   # #     #     # #   #   # # # # #
########### ### # ### ##### ### ### # # ### # ##### # # ### #
#   #   #   #   #   #     # #     # # #   # # #       # #   #
# ##### ### ######### ####### # ### ##### ### ####### # ### #
#       # #     # #         # # # #   #     #   #       #   #
##### ### ##### # # # ########### ######### # # # # # # # # #
# #       # #       #     # #               # # # # # # # # #
# # ### ### # # ##### # ### ##### ### # ############# # #####
# #   # #   # # #     #   #         # # #     # # #   # #   #
# # ####### # ### # ####### ### ####### # ### # # ### ##### #
#   # #   #     # # #   # #   # # #       #     #           #
# # # # # # ##### # # ### ####### # ######### # # # ##### ###
# #   # # #     # # # # #     # #   # #       #   # #       #
##### ### # ####### # # ##### # ### # ### # # ######### ### #
#   #       #   # #         #   # #   #   # # #     #   #   #
# # ### # ### ### # # # # ##### # # ##### ####### ######### #
# #   # #     #     # # #       #   #         # #         # #
### ### ######### # # ### ##### # ### ####### # # ####### ###
# #   #     # #   # # #   # #   #   #   #     #   # #   # # #
# # # # ### # ### # ### ### ### ######### # ##### # # ##### #
#   #     # #     # #   #   #   #         # #   #       #   #
# ########### ##### # ### ##### ### ### ####### # ##### ### #
#   # #       # # # #       #     # #     #     # #         #
# ### # ### # # # ####### # # # # ##### ### ### # ##### #####
#   # # # # # #       #   # # # # #     #   #         # #   #
### # ### ### # ##### ### ####### ### # # ### ####### # ### #
# #   # #       #   # #   #       #   # # #         # # #   #
# # ### ### # ### ##### ##### # # ### ######### # ######### #
# # #   # # # #   #   # # #   # # # #     #     #         # #
# ##### # ### # # ### # # ##### ### ### # # ### # ######### #
# # # #     # # #   # #   #       # #   #   # # #       #   #
# # # # ########### # ### ####### # ### ##### # ##### # ### #
#       # # #   #         #       #   # # # # #   #   # #   #
# ### ### # # # # ### # ##### ### # ##### # # ######### # ###
# # #       # # #   # # #   #   #     # #   # #   #       # #
### ### ##### ### ####### # # ####### # ### # # ####### # # #
# #     #   #     # # #   #   # #   # #     #         # #   #
# # # # ### # # # # # ######### # ### ##### ####### # # #####
#   # #       # # #     #     #     # # # #   # #   #   # # #
##### ############# # ### ### # # ### # # ### # ####### # # #
# #                 # #   #   # # # #       #     # #       #
# ### # # ######### ### ####### ### # # # ####### # ### #####
#     # # #   # #   #         # #     # #     # # #         #
##### ### # # # ########### # # # ######### # # # ### # ### #
#   # # #   # #   #   #     #         #     #         # #   #
# # ### ####### ### # # ### # ######### ### # # ### ### # ###
# #   #       #   # #     # #         # #   # #   #   # # # #
##### # # ####### # ### # ### ### ######### ### # # # ##### #
#       # #   #   # #   #   #   #     #     #   # # # #   # #
### ##### # ##### ### ### # # ### ####### # ### ### ### ### #
#   #   #         #   #   # # # #     # # #   #   #         #
####### # # ########### ### ### # ### # ### ### ##### ##### #
#         # #       # # # # # # # #   # #     # #   #   #   #
# ####### ### ##### # ### ### # # # # # ### # # ### # ### ###
# # #   #   #     #   #   #   #   # #     # # # # #     #   #
### ### # # # # ##### ### # # # ####### ##### # # # # ### ###
#   #     # # # #   # # #   # # # #   #     # #   # # #   # #
# # ### ### # ##### ### # ##### # ### # # # ####### ####### #
# #   # #     # #   # #       # #       # # # #       #   # #
### # # ##### # ### # ### # ### # # # # # ### ##### ##### # #
#   #   # # # #     # #   #     # # # # # # #     #   #     #
### # ### # # # # # # # ####### ### # # ### ##### ### # ### #
#   #     # # # # # #   # # # #   # # # #   #           #   #
# ### # ### ####### # ### # # ### ##### # ### ##### ### # # #
#   # # #         #       #         #     # # #       # # # #
####### ### ######### ##### ####### ##### # ### # ##### #####
#   #   # # # #   #       #     # # # #     # # # #     #   #
# # # # # # # # ############### # # # ### ### # ### ### # ###
# #   #               #     #   # # #         #   #   #     #
# ######### # ### ### ### ### # # # # ### ######### ####### #
#     #     # #     # # #   # # #   # #       #     # # #   #
# ### ### # # ######### # ### # ##### # ####### ##### # # ###
# # # # # # # #     # #       #   #   # #   #     # #     # #
# # ### # # ####### # ### ### ####### # # # # # ### # ##### #
#   #     # #   #   # # # #         # # # #   # # #   #     #
# # ####### # ### ### # # # ### # # # ### ####### ### ### # #
# #       # #   #         # #   # # # # #     # # # #   # # #
### ### ### # ####### ##### # # ####### # ##### # # ### # # #
#   #   # #   # # #   # # # # # #   #   # #     # #       # #
### ### # # # # # ##### # # ### # # # ##### ### # ### #######
#     #   # #         #   # #     #     #   #   #       # # #
# ### # ######### ####### # ####### ##### ### # # ##### # # #
# #   # #       #   #   #       #     #   # # #   #   #     #
##### ####### ### ### # # # # ########### # ### # # #########
#   #   #     # # #   # # # #       # #     # # #     #     #
# # # ####### # # # ##### ### # ##### ### # # ### ##### # ###
# # #   # #   #         # #   #         # #     # # # # #   #
# # ### # # ### # # ### ##### ##### # # # # # ### # # # # # #
# #   # #       # #   #       #   # # # # # # # # # #   # # #
# ### # ####### # ####### # # ### # ### # ##### # # ### ### #
# #   #     #   #   # #   # #     #   # # #               # #
# # # # # # ### # # # # ### ### ### ### ####### # ##### # ###
# # #   # #   # # # #   # #   # #   # # #   #   # #     #   #
### # # ### ##### ##### # ########### ##### ### ### #########
#   # # # #   #   #   # #     #     # #   #   #   #   # #   #
####### # ### # ### ##### ####### # # ### # # # # ### # # ###
#   #     # # # #         #       #         #   #   #   #   #
# ##### ### # # # # ### ### ##### ### ### ##### ####### # ###
#   #   #     # # #   #       #     #   # #   # #     #     #
# ### ####### ################# ### ##### # ### # ### # #####
#     #           #   # #       # # # #   #         # # #   #
# ####### ########### # ### ### # # # ######### # ####### # #
# #     #     #   #       #   #   # #         # #       # # #
# ### # # # ### ### # # # # ######### ##### # ### # ####### #
# #   #   #     # # # # # #       # #     # # # # #         #
# # # # ##### ### # ### # # # ### # # ##### # # # # ### # ###
# # # # # #     #     # # # #   # #       # # #   #   # #   #
# ####### # # # # ### ### # ### ### ### ##### ##### ##### ###
# #     # # # #   #   # # # # # #   # #   # #     #   #     #
##### # # # ### # ### # ##### ####### # ### # # ########### #
#   # #     #   # # #     # #     #       #   #   #     #   #
# # # ####### ### # ####### # ######### ##### ##### #########
# #   #   # # # #       # #         #       #   #           #
# # # # # # ### # # ##### # ##### # ####### ####### ### ### #
# # #   #   #     # #           # #     # # # # # # #     # #
##### ######### ### # ### ####### ### ### # # # # # # ##### #
#   #   # #   # #   # #     #     #     #           #   # # #
# # # # # # ##### ##### # ####### ##### # ##### # ####### ###
# #   # #     #     # # # # #   #     # # #   # #       # # #
# ##### # ####### ### ### # # # ### ### # # # # ##### ### # #
# #   # #     #   #           # # # # # #   # #   #   #   # #
### # ### # ##### ### ########### # # ### ##### ####### # # #
#   #   # #   # #   # # #   # # # #     #     #   #     #   #
### ### ##### # ### # # # # # # # ### ### ### # ##### # #####
#   #   #     #   #   # # #         #     #   # #     #     #
### ### # # ### # # ### ### ### # # # ######### ####### #####
# # #     #   # # #     # #   # # #   #   # #   #       #   #
# ### ##### # ### ### ### # ### ### ### # # ### # # ####### #
# #   #     # # # #     #     #   # #   # # #     # # #     #
# ####### ##### # ### ####### ####### ##### ##### ### # # ###
#   # #           #     #   #   # #     #   #       #   #   #
# # # ### # ### ### ####### ### # ### ### # # ######### #####
# #   #   #   #         #       #         #             #   #
# ### # ### # ### ##### ### # ####### ### # ##### ####### ###
#   #     # # # #     # #   #       # #   # #   #   # #     #
######### ### # ### ##### ########### ####### ### ### # # # #
# #     #   # #         # #   #       # #             # # # #
# # ####### # ####### ### ### ### ##### # ### ### ### # # # #
#   # # #   # #   # # #   #           #   #     # # # # # # #
# # # # ####### ### ####### ### # ####### ######### # # #####
# # # #     # #       #       # #     #   #               # #
# ### # # # # # # ### ### ### ##### # # ####### ########### #
#       # # #   # # #   #   # #   # # #     #       #       #
### ########### ### ##### ### ### ### # ##### ### # ##### ###
#   #     #       # #   #   #     #   #     # # # # # #     #
### # ##### ##### # # # # # ################### # ### # #####
# #         #   # #   #   #   # #       #           # #     #
# # # ### # # # ### ### ### ### ### ######### ####### # #####
#   # #   # # # #   # #   #     #     # #       #       #   #
### ##### ### # ##### ### # # # ### # # # # # ##### # # ### #
#   #   # #   #   #     # # # #   # #     # #     # # #     #
##### # # # # # # # # # ##### ##### ##### ### ### # ### # ###
#   # # #   # # #   # #   #     # # #   #   # #     #   #   #
# ##### # ####### ### ##### # ### # # ### ### # # ### ##### #
#     #   # #   # #   #   # # #   #   # # # # # # # # #     #
### # ### # # # ##### # ##### # ### ### ### # ### # ### # # #
#   #   # #   # # #               # # # #       # #   # # # #
# ####### # # # # # ### ####### # ### # # ### # # # # ### ###
#       #   # # #     #   #     # # # # #   # # # # # # #   #
# ##### ### ##### ### ############# # # # # ### ##### # # # #
# # #         #   #   #     #   #     #   # #     #   #   # #
# # ### # # # # ########### # ### # ### ########### ####### #
# # #   # # # #   #       # #     # # # # # #         # #   #
### ##### ### ### # ### # # ### # ### # # # ### # ### # # # #
#         #   #       # #   # # #     #   #   # #   #   # # #
####### ##### ### ##### ##### # ### ### # # ### ########### #
#   # # #   #   # #   #   #   # #   #   #             #     #
### # # ### # ### # ######### ##### # ### # # # ######### ###
#     # #       # #     # #     #     #   # # # #           #
# # ##### ### ### # ### # ##### # ######### # # ####### # ###
# # #   # #   # # # #   # # #   #   #   # # # #     #   #   #
### # ##### # # # ##### # # # # ##### ### ### ##### ####### #
#   # #   # # #       #       # # #       #   #   #   #     #
### # ### # # ####### # ##### ### # # # ### ### ##### # ### #
#           #   #     #   #   #     # #     #     #   # #   #
### ### ####### ### # ### # ### ####### ### # # ##### ##### #
#     #     #     # #     # #     #     #     # #     #     #
########################################################### #
