# ###########################################################
#   # #     # # #   #   # #     #   # #     # #   #   # #   #
### # ##### # # # ### ### # ####### # ### ### # # ### # ### #
# #   # # # # #           # # #       #         #       #   #
# # ### # # # ##### ####### # ####### ############# # # # # #
#   #   #   # # #             #   #         #       # #   # #
# ##### ### # # # ######### # ### ##### # ####### # ### ### #
#   #                 # #   #           #         #   #   # #
### ####### ### ##### # ##### # # ### ### # ########### #####
#       # #   # #   # # #     # # # # # # #   #       #     #
# ### # # ### ### # ### # ##### ### ### ####### # # ####### #
# #   #   # # #   #           # #     # #   # # # #       # #
# ####### # ### # # ########### ### # # # # # ##### ##### # #
#       #   # # # # #     #     # # #     #       # #     # #
####### ##### ### ##### # ### ### # # ##### # ######### # ###
# # #     # #     #     # #     #   #   #   # #         # # #
# # # ##### # ### ##### # ##### ### ##### # ##### ### ##### #
#         #     # # #   # #   # #       # #   #     # #     #
####### # # # ##### # ####### ### # # # # # ### # # ### # ###
#   #   #   # # #       #   # # # # # # # # #   # # #   #   #
# ##### ####### # ##### # ### # ######### # # ### ### # # ###
#       # #   #     #       #         #   # # #   #   # #   #
##### ### ### # ##### ####### ##### # ##### # ### ##### #####
#   #       # #     #   #       #   #   # #   #       #   # #
### ### # # # # ######### # ##### # ##### # ####### # ### # #
#       # #   #     # #   # #   # # # # # #     #   #       #
# ######### ### # ### ######### # ### # # ### ##### ####### #
#   #   #       # # # #       #       #           # # #   # #
# ### # # ##### ### # # ####### ### # # # ### # ### # ### ###
# #   #     #       #     #   # #   #   # #   # # #     #   #
# ### ############# ##### ### ### # # ### ### # # # # ### ###
# #   #         # # #     #       # #   # #   # # # #       #
### # ##### ##### # # ####### ### ### ### ####### # # # # ###
# # # #   # # # #       # #   #   #   #   #   #     # # # # #
# # ### ### # # ### # # # # # ### ####### # ######### # ### #
#   # # #   # # #   # #   # # #   #   #     # #     # # #   #
# ### # ### # # # # # # # ### ##### ##### # # # # # ####### #
#     #   #   # # # # # #   # # #         #   # # #       # #
### ##### # ### ##### # # ### # ############# ####### ### # #
#     #         #     # # # #   # #   #     # #   #   #     #
# # # ####### # # ####### # ### # # # # ##### ### ### ### # #
# # #   #     # #     #     #   # # #         #       #   # #
# ### ######### ##### ### ####### ##### ### ##### # ### # ###
# #       #     # # # #   #   #     #   #     # # # #   #   #
# ### ######### # # ##### # # # # ##### # ### # ### ##### ###
#   #   #             #     #   # #   # #   # # # #   # #   #
####### # ### ### # ##### # # # ##### ### ##### # # ### ### #
# # # #   #   # # # #   # # # # #   # #     # #         # # #
# # # ##### # # ####### # # ##### ### ### ### ########### # #
#     #     #     # #     # #     # #             #         #
# # # # ########### ### ### # ##### ### ### ########### ### #
# # #   #   #   #       #                 #     #   # #   # #
##### # # ##### # # ### ##### ### ##### ##### ##### # ### ###
# #   # #       # # #   #   #   # #       #   #       # #   #
# # ### ### ### # # ### # # # ##### # ########### ##### # ###
#     # # #   #   # #   # # # #   # # #       # # #   #     #
# ####### ### # ########### # # # ####### ### # # # ### # # #
#   #         #     #   #     # #           # #   #     # # #
##### # # ##### # # ### # ### ######### ##### # # # ### # ###
#     # #   #   # #     #   #               #   #     # #   #
########################################################### #
