# ###########################################################
#   # #     # #       #   # # #           # # #         #   #
### # # ##### # ### ### # # # # ### ####### # ### ##### # ###
#   #   #     # #     # #       # #   # # #   #   #     #   #
### ### ### ##### # ### ##### ### # ### # # ##### ### ### ###
#   # #   # # #   #   # #   # #   #             # #         #
# ### # ### # # ##### ### ### # ######### # ##### ####### # #
# #               #     # # #       #   # #     # #   #   # #
# ### # ######### # ##### # # ### ### ####### ### # # # #####
#     #   #       #   #       #           #         # #   # #
# ##### ##### # ####### # ### ### ####### ############### # #
# #     #   # # #     # # #   #     #       # # #     # #   #
# ######### ### ### # # ####### ### ### # # # # # ##### #####
#   #       #     # # #     # # # # # # # #   #       #   # #
### ####### ### ##### ##### # # # ### # ### # ### # # ### # #
# #   #         #   #   #   #     #       # #     # #       #
# ######### # # ### # ##### ##### ### ##### # ##### ### ### #
# #       # # # #       # #   #   #     #   # # #   #     # #
# # ##### # ### # ##### # ####### # ### # ### # # # #########
# #   #   #   #     # #     # #   # #   # #     # #   # #   #
# # ##### ##### # ### # ### # # ### # ### ####### # ### # # #
# #     #   #   # #       #   # # # # # #     # # # #   # # #
# ##### ##### # # # # # ##### ### # # # ### # # # ### # ### #
# #   #     # # # # # # #   # #   # # # #   # # #     #     #
# # ### # # ##### ### ### ##### # ##### ### # # ### ### # ###
#     # # # # # # #     # #   # # #   # #   # #     # # # # #
### ####### # # # # ##### ### ### # ### ##### # ### # ##### #
#   #         #   #   #       #       #   #   #   # # #     #
### ##### ########### # # ##### ### ### ######### ### ### # #
#           #   #       #   #   #     # #   # # #         # #
# ### # ### # # ### ### ### ### # # ### # ### # # ######### #
# #   # # #   # #     # # # #   # #   #                 #   #
##### ### # # ### ####### ### ### ##### # ####### # # ##### #
# #       # # #     # #     #   #   # # # #   #   # #   #   #
# # ####### # ### ### ##### # ### # # ### ### ### # # # #####
#   #     # #     # #         #   # #         #   # # #   # #
# ##### ##### ### # # ############# # ####### ### ####### # #
#       #   #   # #     #   #     #   # # # # #   #     #   #
# ### ##### ##### # ### # # ### ### ### # # ### ####### #####
# #   #               #   # # #   #     #     #   #     # # #
# # # ####### ##### ##### ### ### ### # ##### ##### ### # # #
# # #   #     #   # # #         #     # # #   #   # #       #
# ########### # ##### ### ##### # ### ### # ### ### # ### ###
# #   #   # # #   #   # #   # # # #     #   #       #   # # #
# # ### ### # ### ### # # ### ##### ### ### # # ### ##### # #
# # #       # #           # #   #   #   #     # #     #   # #
# # # # ####### # ### ##### # ### ### ####### ##### # ##### #
# #   #     #   # # #   #     #   # # #           # # #   # #
# ##### ####### ### ######### # ### # # # ##### ### ##### # #
# # #       #           #   #       # # # #     # # # # #   #
### ### # # # ##### # # # # # ### ############# # ### # # # #
#   #   # #   #     # #   # # #     #   #           #     # #
# # # ##### ### # ############### # # ##### ######### ### ###
# #     #     # # #     # # #     #       #             #   #
# ####### ####### # ##### # ### ####### # # # # ########### #
# #     #       #     #     #     #     #   # #           # #
# # ##### ##### # # ### ########### ### ##### # # ### ##### #
# # #     #     # #     #   #     # # #   #   # # #   #     #
# # # ######### ### ### # # ### ### # # # # # ### ####### ###
#   # #         #   #     #       # #   # # #   #   #       #
########################################################### #
