# ###########################################################
# #     # # #   #   #     # # #   # #     #   #     #       #
# # ### # # # ### # ### # # # # ### # ### # # # # # # # ### #
#   #       #     #   # #       # #   #     #   # # # #   # #
# # # # # # ### # ### ##### ### # ##### ####### ######### ###
# # # # # # # # # #   #       # #     #       #   #       # #
# ##### ### # # ##### ### ##### # # # ### ### # # # # ### # #
# #     # # # # # # #   #     #   # # # # #   # # # # #   # #
##### ### ### ### # # # # ##### ### ### ####### ### ##### # #
#     # #   #     #   # # #       #     #     # #   #       #
# # ### ### ##### # # ### ####### # ### # ##### ######### ###
# #     #       #   #     # #     # # # #   # #             #
# ##### ### # ##### ### ### # ##### # ### # # # # ##### #####
#   #     # # #     # #   # #   #   # #   #   # #   #       #
# # ##### # ######### ##### ##### # # ##### ####### ### # ###
# # # #   # #       #             # # # #   #     # # # #   #
# ### # # # # # ######### ### ##### # # # ### # ##### # # ###
# # # # #     # #   # #   #   #       #   # # #   #     #   #
# # # # # # ##### # # # ########### # # ### ### ### ##### ###
# # #   # # #     #   #     #   #   #     #   #   #   #     #
# # ### ### # # ### ####### ### ######### ### # ### ### # # #
# #   # # #   #   # #   # # #     #       #   #     #   # # #
# ### # # ##### # # ### # ##### ### # # ### # # ##### # # ###
# # #       #   # # # # # #     # # # #   # #       # # # # #
### ### ### ##### ### # # ##### # ####### ####### ##### # # #
# # # # # # #   #     #               #     #     #     # # #
# # # # # ### ##### # # ### # # ### ### ### ######### ##### #
#   #   #     #   # #   #   # # #         # #     #     # # #
### # # ##### ### # # ### ### # ############# # ####### # # #
# #   #     #     # #   # #   #             # # #     #     #
# # ####### ### ### ##### # ### ### ##### # ### ##### ##### #
# # #       #       # # # #   #   # #   # #   #     # #     #
# # ### # ######### # # ##### ### ### ####### ### ### ### # #
#     # #   #       #   #     # # #     #         # # #   # #
# # ##### ##### ### ### # ##### ####### # ### ### # # ### ###
# #   #     #   # # #   #     # #   #     # # #   # #       #
# ####### ####### ### # ####### # # # ##### ### ### ### ### #
#   # # #   #   #     #   # #   # # # # #   # #     #   #   #
# ### # # ##### # # # ##### ### # ### # # ### ### ### ##### #
#   # #       #   # #           # #   #       #     #     # #
##### # ####### ##### ######### # ### # # ### ##### ### #####
#     # #     #   # # # #     # #   # # #   #   #   #       #
# ####### ### # ### ### # ### # # ### # # ### ##### ##### ###
#   #   # #   #   #   #   #   # #   #   # # #   # #     #   #
# ##### # # # ### # ######### # ### ### ### # ### ### ##### #
#         # #     #       # #           #   #     # # #   # #
### ####### # ### ####### # ####### ### # # ##### # ##### # #
#   #   #   #   # #     #         # #   # #     #   #   # # #
### ### ### ##### ##### ### ### ########### # ##### ### # # #
# #   # #       #         #   #     #     # #       #     # #
# ##### ##### ####### ### # ### ### # # # ### ### # ### # # #
# #   #     # #   #     #   #     # # # #       # #   # #   #
# ### # # ### ### ####### ### ### ####### ######### ### ### #
#       #     #   # # #     # #     # #   #   # #     #   # #
##### ### ### # ### # ### ##### ##### ##### # # ### # ### ###
# # # #   # # #   #       #       #   #     #     # #       #
# # ####### # ### # # ########### # ############# # # # #####
#   #         #     #   # # #     #   #             # #     #
# # ##### # ##### ##### # # ##### # # # ### # ####### ### ###
# #       # #     #         #     # #   #   #     #   #     #
########################################################### #
