# ###################################################################################################
#   #   # #     #   #       #     # # #   #   # #   #   #           # # #       #         # # # # # #
# ### ### ### ### ##### ### # # ### # ### ### # ### # # # ######### # # ### ####### # ### # # # # # #
#             # #         # # #         #         # # # # #       #   #   #       # #   # #         #
### # ##### # # ####### ### # ### # # # ### ##### # # ####### ####### ### # ######### ### ####### ###
#   #     # #         # # # # # # # # # # # #   #       #           # #   #           # # # # #     #
# ### ### ####### ### # # # ### # ### ### # # ######### ##### ##### # # ### ### # ### # # # # # #####
# #   #   #   #   #   #   #       #     #             #         #         #   # # #     #       # # #
##### ##### ### # ######### ######### # ##### # ### ######### ##### ########### ######### # ##### # #
# #       #     #   #       #     #   #   #   # #     # #   # #   #     #   #   #   # # # # #       #
# ######### # # ##### # ##### ##### ####### ### ####### # ### ### ### ### ##### # # # # # ### ##### #
#   #   #   # #     # # #   # #           #   #   # # # # # # #           #     # #       # #   #   #
# # # # # ### ### ####### # # # ##### # ### ### ### # # # # ### ####### ### ########### # # ### # ###
# #   #     # #   #       # #   #   # # # # # #   # #   #   # #     # #   # #   #   #   #   # # #   #
# # # ### ####### # ### ### ####### ### # ### ### # # ### ### # # ### ### ##### # ####### ### # ### #
# # # #   # # #     #     # # #   # #   # #     # #   # # #     #   #     #   # #       #   # # # # #
######### # # ### ##### ##### ### # # ### # # ### ### # # ### # # # ### # # ### # ### ### # # ### # #
#       #     #   # #           #       # # #             #   # # #   # # #   #     #     # #       #
##### # ### ### ### ####### ### # ##### # # ##### # ######### ####### # # # # # ### ######### #######
#     # # # # # #   # #   # #   # # # #     # # # # # #     # # #     # # # #   #     # #     # #   #
##### # # # # # # # # # # ##### ### # # # # # # # ### ### ##### ### ##### # ####### ### # ##### # ###
#     # #     # # #   # #       # #     # # #       #     #   #       #       #                 #   #
# # # ### # ######### # ####### # ################# # ### # ### ### ### ### # ########### # # ### ###
# # # #   # # #   # #     #     #       #               # # #   #     # # # #   #   # # # # #       #
# ######### # ### # # ##### ### # ### ### ####### # ####### # ########### ##### # # # # ####### ### #
#         # #   #   #     # # # # #   #   #     # # #     # # # #   # #     #     # #   #   #   #   #
# # ####### # # # ##### ### # # # ####### # ######### ### # ### # ### ### ### ### ### ### ### # #####
# # # # # # # #     #     # #   #     #     #   #   # # # #       # #           #       #     #     #
# ### # # # ##### ### ####### ### ### ### ### # ### # # # ##### # # ######### # ##### ### ### # #####
#   #       #       #   #   #       #     # # # # #   #       # #       #     #   #     # #   #     #
### # ### ######### ### # # ### ### # ##### ### # # ######### # ##### # ####### # ### ##### # # ### #
# #     #     #   # # #   # #     # # # #     #   #   #     # #   #   # #       # #     # # # # # # #
# # # ####### # ### # # ######### ### # # ##### # # # # ##### ### ####################### ### ### # #
# # #       #   #           #   # #     #     # #   #     #       #               #     # #   #     #
# ### # # ######### # ##### # ### ##### # # ##### ##### ### # # ### ######### ##### ##### ### ### ###
#     # #   # # #   #   # #     # #     # #   #   #       # # # #   # #       #       #   #   # #   #
##### ####### # # ##### # ##### ####### # ####### ##### ####### ##### ####### ##### ##### ##### #####
#   #       #       #         #   #     # #     #     #   #   #   #           # #             #     #
# # # ### ##### ### # ### ######### # ### ### # ##### ####### ######### ### # # # ####### ##### ### #
# # # # # #       # # # # # #     # #     #   # #       #     #   #   # # # # # #     # # #   # #   #
### ### ##### ### ### # ### # ### ### # # ##### ##### ### # # ### # # ### # # # # ### # # ### # ### #
#   #     # # #   # #   #       #   # # #       # #     # # #       # #   # # #   # #   # # # #   # #
# ### # # # ####### ### ##### ### ############# # # # ### ##### ### ### # ### ##### # ##### # ### ###
# #   # # # # # #         # # #               # #   # # #     # #   # # #       #       #     #   # #
# # ##### # # # # ### ##### ##### # ### ##### ##### ### ### ####### # ##### ### ####### # # ##### # #
#       # #   # #   # #   # #     #   #   #               #   # # # #   #     #       # # # #       #
# # ### ### # # # ##### # # ### # ### # ##### # ### ### ##### # # # ### # ##### # # ### # ### ### ###
# # # # # # #     #     # #     # #   #   # # # #   # #     # #   #         #   # #   #   # #   #   #
### # # # ##### # # ######### ##### ##### # ### # # # ##### # # ######### # ##### ### # # # # ##### #
#   #           #   # # #     #     #   # #     # # # # #   #         #   # # # # #   # # #   #   # #
### # ##### ### # ### # ##### ####### # ######### ### # # ##### # # ##### # # # ### # # ##### # # # #
#   #   #     # # # # # # #   # # #   #         # #           # # #   #   # #     # #   #     # # # #
# ### ########### # # # # # ### # ####### ##### ##### ### # # ### # # # ### ### ####### ### # ### ###
# #             #             #     #       #   #   # # # # #   # # # #   #   # #       #   # #     #
##### # ########### ### ####### # # # ######### # # # # ########### ####### # # ##### # # ######### #
# #   # #   # #     #     #     # # #   #     # # #       #     #     # #   # #       #   #     #   #
# ### # ### # ##### # ####### # ### ##### # ### ### ### # ### # ### # # ### ### ### # ####### # # # #
#   # # # #       # #       # # #       # #           # # #   #   # # #     #   #   # #       # # # #
# ### ### # ### ##### ####### ##### # # # # ### # ### ### ### ######### # ####### ##### # # ### # # #
#       # #   # # # #     #   #   # # #   # #   # # #   # #       #   # #   #   #   #   # #   #   # #
# # # ### # # # # # # # # ### ### ### # ### ### # # ### ##### # # # # # ####### # ############# # ###
# # #   #   # # # #   # # #   #   # # # #     # # # #       # # #   #   # #   #     #       # # # # #
# ### ##### ### # # ############# # ### # ### ##### ##### # ### ### ##### ### # ##### # # ### # # # #
# #       # #     #       #   # #     # #   #   #     # # #     #           #   # #   # # #   # #   #
# ##### ####### # # ### # # ### ### ####### # # # ##### ### ######### ### # ### # ##### # ### # # # #
# #     # #   # #   #   # #     #       #   # # # #             # #   # # # #     #   # # #     # # #
### ### # # ####### # # # ### ##### ### ### # ### # ##### ### ### ### # ##### ### # ### # ### ### ###
# # #   #   # #   # # # #         # # #   # # # #   # #     # #         #     #       # #       #   #
# # ##### ### ### # # ####### ##### # # # # ### ### # ### ### # # ##### # ### ####### # ##### ### # #
#       # # # # # # #   # # # # #   #   # # #     # #   # # # # #   # # # #   # #     #     #   # # #
# ### ### # # # # # ##### # ### ### # ### # ### ### ### # # ### ##### # ### ### ##### # # ###########
#   # #     #         #     #       # #     #   # # #     # # #   #     # # # # #     # # #   #   # #
### # # ####### # ### ### ####### ##### ##### ### ##### ### # ##### # ### ### # ### # # # ### ### # #
#   #       #   # #   #   #     #     # # #     #     # # #   # # # # #             #   #   # # #   #
##### ########### ### ### ### ########### ### ### ####### # ### # # ####### # ######### ### # # ### #
#   #   #   #       #           #   #       # #             #       #     # # #   #     #     #     #
# ####### ##################### # # ### ##### ######### # # # # ### ##### ####### # ##### # # # ### #
# #   #   # #         # #     # # #     # # # #         # #   #   # #   #   #   #   #   # # #     # #
# ### ### # ##### # ### ##### ### # # ### # # ######### ### # ####### ### # # ### ### # ### ### ### #
#       #     # # #         #     # # #   #   #   # # # # # #   #   #   # # #       # #       #   # #
# ##### ### # # ####### ####### ####### ##### ### # # # # ##### ### # ##### # ### ### ### # ##### # #
# # #   #   #     #   # #       #         #     # # #   # # # #     #   # #     #   # # # # #   # # #
# # ### # ### # ### # # ####### # # ##### ### ### # # ### # # ##### # ### # ##### # ### # ### ### ###
# # # # # # # #     # #   # #   # #   #   # #         #     #   # #       #   #   # #     #     # # #
# # # ### # # # ### ##### # ### ######### # # # ### ##### # # ### # # ##### # ##### ### ####### ### #
#     #     # #   # # #     #     #     # #   # #   #     # #   #   #   # # #     # # #   # #       #
### # # # # ### ##### # ### ### # # ##### # ####### # ### ### # ####### # ########### ### # # # ### #
# # #   # # #   #     #   # # # #         #   #         #   # #   #   #           #     #     #   # #
# ### # # ### # ##### # # # # # # # ############# ### # ### ### ### # ### ### ### ### # ### # #######
#     # #   # # # #   # # # #   # # #           # #   # # # #       #   #   #   #     #   # #       #
# # ### ### ##### # ##### ### ### ######### # ##### # # # ### ### # ### ####### # ##### ##### # ### #
# # # #   #     # # # #       # # # # #     # # #   # #   # #   # # #   # # #   #     #   #   # #   #
##### ##### # # # # # # ##### # # # # ####### # # ##### # # # ########### # ### ### ### #############
#           # #         #     #   # #           # #     #           #     #       #   # #   # #     #
### ##### ##### ### ### # ### ##### # ######### # ### ### # ####### # # # # ####### # # # ### # #####
#     # # # #   #     # # #     #   # #   # #     #   #   #     #   # # # # # # #   # #             #
####### # # ####### ########### # ### # # # # ########### # ##### ####### ### # ################# # #
# # #       # # # #         # #       # # #     #   #     #   #         #         #     #     # # # #
# # # ####### # # ### ### ### # # # # ### ### ### ####### ### ### ### ### ### # # # # ####### # # ###
#                 #     # #     # # #       #       #       # #   #         # # #   # #             #
################################################################################################### #
