#####################################################################################################
# #   #       #     # #   #         # #   #   #   #   # #   # #     #       # #   #       # #       #
# # ##### # ### ##### # ##### ####### ### ### ### ### # # ### ##### ####### # # ##### ##### # # #####
# #       # #     # #   # #       # # #         # #     #       #     #             #       # #     #
# ### ######### ### # # # # # # ### # # # # # # # ### # ##### # # # ### ##### # ##### ### ##### #####
#       #   #   #     # #   # # # #   # # # # #   #   # # #   # # # #     #   # #       # #   # #   #
### ##### ### # ### # ####### ### # ######### ####### ### ##### # ######### # ####### ##### ### ### #
# #   #     # # #   # #   #       # #       # # # #   #       #   #   #     #           #       # # #
# ### ##### # ##### # ### # ### # # ### ### # # # # ##### ### # # ### ### # # # ##### ### ### # # # #
#         # # #     #     #   # # #   # #     #     # #   # # # #         # # # #   #   # #   #   # #
### ### # # # ### ### ### ### ### # # # # # ### # # # ##### # # # # # ### ####### ##### # # ### ### #
#   #   # #   #   #   # #     #   # # # # # #   # # # # #   # # # # #   # #       #   # # # #       #
# # # ####### ######### ### # ####### ##### ### ##### # # # # ####### ##### # ### ### ####### # # ###
# # #   #     # # #       # #     #   #                 # #   #     # # #   # #   # #         # # # #
# # # # # # # # # ### ####### ##### ### # # ### ### ### # ##### # ### # # # ##### # ########### ### #
# # # # # # #           # # #     # #   # # #     #   #         # # #     #   #       #       # #   #
### ##### # # ######### # # # # # # # # ################### ##### # ####### # # ####### # ##### ### #
# #     # # # #   # #     #   # # #   # #   #         #   # #   # #         # #         #   # #     #
# # ### ##### # # # ### ### ### # # # ### ### # ### ##### # # # # ### # ### ### ### ##### # # # #####
#   #   #       #     #     #   # # #   #   # # #     #   #   # # #   # # #   # # # #     #         #
### ######### ### ### ### ### ####### # # ### # ####### ### # ######### # ### # # ### ### # ### #####
# #   # # # # #     # #     # # #     #     # #       #     # #     #     # # #     #   # # #   # # #
# ### # # # ### ### ##### ### # ### # # ##### ######### ### ### ### # ##### # # ##### ####### # # # #
#     #     # #   # # #   # # #   # # # #       #     # # # #   #     #     # #     #     #   #     #
# ### # ### # # # ### # ### ### ### # ### ### # # ##### # # # ########### # ####### ####### # ### ###
# #   # #   # # # # #   #     #     # # # #   #     # # #             # # # #   # # #   #   # #   # #
# ####### ### ### # # # # ### ### # ### # # ### ##### # # ##### ### ### # # # ### ### # ##### # # # #
#       # # #     #   # # # #     #   #   # # #   # #   # # #     #       #     # #   #     # # #   #
####### # # # ##### # ##### ### ########### # ### # ##### # ########### ### ##### ######### ##### ###
#           #     # # #         #     # #   # # #         #       #     #   #       # # # # # #   # #
### ##### ##### ### ##### ##### # # # # # # # # # # ### ### # ### ### ##### ##### # # # # # # ##### #
#   # #   # #   # # #     #     # # #   # #   # # #   #     # #   # #   #     # # #   #     # #   # #
# ### ### # ##### # # # ####### ##### # ##### # # # ######### # ### ### ##### # # ####### # # ### # #
#       #   # #       # #   #   #     #   #     # #   #     # #   #   # #       #       # #         #
# ### ####### ### # # ##### ### # # # ######### ####### ### ##### ### ##### ### ##### ######### #####
# # #   #   #     # #   # #   # # # # # #                 # #         #     #                   # # #
# # # ##### ### # # # # # ### ### ### # # # # ### ### ##### # ### # ### ######### # ### ### # ### # #
#   # #   #     # # # #     # #   # #   # # #   # # # # # # # # # # # # #   #   # #   # #   # #     #
# # # # ##### ##### # ####### ### # ### ########### ### # # ### ### # ##### ### ### # # ##### ##### #
# # #       #   # # # # #       #   # #     # #     # #     #   #       #           # # # #   #     #
####### ##### ### ##### ##### ### ### # ##### # # # # # ##### ##### ############### ##### ### # #####
#   #           #   #   # #       #   #         # #   # # #   #   # #     # #     # # # #   # #   # #
### ### ### ####### # ### ##### # ### ### ### ##### ##### # # # ### ### ### # ### ### # ### # # ### #
#     #   #   #   #     #   # # # # #       #   #     # #   #   #   #     #   # # #     #           #
### ### ##### # # # ### ### # ### # # ############# ### ##### # # ##### ### ### # ##### ### ### ### #
#       #     # #   # # #   #     # #     # #     # #   #     #     #   #   #   # #       #   # #   #
##### # ### ### ##### # # # # # # # # ### # ##### ### # # ##### ### # ##### # ######### # ##### ### #
#     #   # # # # #     # #   # # #   #         #     #     #   # #     # #           # # # # # #   #
# ####### # # ### # ### ##### ### ##### # # ### ##### # ######### ### ### ### ### ##### # # # ##### #
# #       # # # #     # # #     # #   # # #   # #   # #   #       #   #   #   # #   #   # #     #   #
### ### ##### # # ##### # # ######### # # ##### # ##### # # ### ##### # # ### # # # # ### ##### #####
#     #   # #       # #   # #   #   #   # #   # #     # # #   #     # # #       # #     #   #   #   #
# ### ### # ### # ### # ##### ### ### ##### ### # # ### ### ######### # # ### ### # ##### ##### ### #
#   #   # #   # # #   #         #     #   #   #   # #           # #     #   # # # #   # # #         #
######### # ##### # # ##### ##### ### # ### # ### ### ####### ### ############# # # ### ##### # #####
#       #       # # # # #       #   #   #   #   # # # #   #   # #     # #   #   # #   #   # # #     #
# ######### # # # ### # ##### ### ### ### ### # ### # ### ##### # ##### ### ### # # ### ### ##### ###
# # #   #   # #       #   #   # #   #       # #   # # # # # # #       #         # #       #   #   # #
# # # ### ##### ##### ### # ### # ### ### ####### # # # # # # ### ### ### ##### # ##### ### # # ### #
# #     # #   # #     # #       #   # #   #   #     #       # #     #     #     #   #     # #     # #
# # ### # # # # # ##### ##### # # ### # # ### # # ########### ######### ##### ### ######### # # ### #
# #   # #   # # #   #     # # # # #   # # #     #   #     #   # # #       #         #       # #     #
# ##### # # # ### ### ##### ####### # ######### ####### # # ### # ######### ### ### ### ####### # # #
#       # # # #   # #   #     # # # # #   # #   #   # # #     #     #     # # #   # # # # #     # # #
# # ### # ### # # # ### ### ### # # ### # # ##### ### # ### # # ### ##### ### # ### # ### ####### ###
# #   #   #   # #         # #   #   #   # #           # # # # # #       # #       #       #       # #
# ##### # # ##### ### ##### ### # # # ######### ##### ### # ####### ##### ##### ####### ### # # # # #
#   # # # #   #     #   #   #     #         # #   # # # #     #       # # # #   #   #     # # # #   #
##### ##### ##### ######### ##### ####### ### # # # # # ### ### # ##### # # # ##### # ### # ##### # #
# #     # # #   # #     #           # #     #   # #     #   #   #                   # #   # # # # # #
# ##### # ##### # # # # # ########### # ### ##### ### ##### # ####### ######### ### # ### # # # # ###
#         #         # # # # #       #   #   #     # #   #     #   # #   # #   #   # #   # #     #   #
# # ##### ####### ### ##### # ### ### ####### ##### ### ### # # ### ##### # # # ##### # # # ####### #
# #     #     #   #     # # #   #           # #             # #         # # #   # #   # #   #   #   #
##### ##### ### ##### ### # ### ########### ####### ### ### ##### ### ### ##### # # # # ##### ##### #
# # #   # #         # #     # # #     #   #     # # # # #   #     #   #           # # # #   # #     #
# # ##### ####### ### # ##### # # ####### ##### # ### # ########### # ######### # ####### ### # # ###
#   #     #         # #     # #     #     #       #   #         # # #           #     #     #   #   #
### # ######### # ####### # # # ####### ##### ### # # # # ### ### # # ### ### ### ####### ######### #
#   # #     #   # #   # # # #           #       #   #   #   # #   # #   #   #   #   #     #     # # #
# ### ### ##### ##### # # ### ####### ##### ### ### ### ##### # # ### # ##### ### # ### ####### # ###
#     #   #   # # #   #   # #       # #     #     # #     #     #   # #   # # # # #   #   #   #   # #
# ### ### # ### # # ### ### # ####### # # # ######### ####### # # ### ##### # # ### # ### ### # # # #
#   #   # # #   # #     # # # # #     # # # #     # # # #   # # # #   #     #   #   #         # # # #
### ### # # ##### ### # # # # # ### # # ### # ##### # # # ### # # ### # # ####### ##### ####### # # #
#     # #     #   #   # #   # #   # # # # # #   #       #     # #   #   #     #   # # #     #   #   #
##### ### # ### # ##### # ##### ### ##### ### ####### ##### ### # # ##### ####### # # # ######### # #
#       # # #   # #   #   # # #     #   #   # #   #   #   #   # # # #   #   #       # #     #   # # #
# # # # ### # ####### ### # # # # # ### # ### # ##### ### ##### ####### # ### ####### ### ##### ### #
# # # # #     #       # #     # # #     # #     #       #   #           # #   #           # #   #   #
### ### ### # # ##### # ### ####### ##### ### # ##### ##### # ####### ##### ### ####### # # ### # ###
# # #   # # # # # #     #         # # # #   # #       # # #     #   #   #   # #   # #   # #     #   #
# # ##### # ##### # # # ### ### # ### # # # # ######### # ### # # # ##### ### ##### # # ### ### # ###
#   #           # # # #     # # # #       #     #   #     #   #   # # # #   #     #   # # #   #     #
# # # ### ### # # # ### ### # # # # # ### ### # # ### ######### ### # # # # # # ### # # # ##### ### #
# #     # # # #       # #   #   #   #   # #   # # #       # # #   # # # # #   #   # # #     #     # #
####### # # ##### ####### ####### ######### ##### ##### # # # # ### # # # ### ####### ####### ### ###
#       # #           #     #           # #           # #   #     # # #   #   #     #         #   # #
####### # # ##### ### # ##### # # ### ### # ####### # ### ####### ### # ##### ### ### ##### ### # # #
#       # #     # #   #   #   # # #   #           # #       #         # #           # #     #   #   #
#####################################################################################################
