######################### #################################
#       # #     #   #     #         #         #       #   #
# ##### # # ### # ### ### # ####### # ##### ### ##### # # #
# #     #   #   #     #   # #     # #     #   # #     # # #
# ### ####### ######### ### # ##### ### ##### # # ##### # #
# #   #       #       #     # #     #   #     # #       # #
### ### ####### ##### # ##### # ##### ### ##### ####### # #
#     # #     #   #   #       # #     #   #     #   #   # #
# ### # # ### ### # ##### ##### # ##### ### ##### # ##### #
#   #   #   #   # #     # #   #       # #   #     #     # #
# # ####### ### # ##### ### # ####### # # ####### ##### # #
# #       # #   # #         #     # # #   #     #   #   # #
####### ### # ### ############### # # ### ### # ### # # ###
#       #   #   #   #   #         #   #   #   #     # #   #
# # ##### ##### ### # # # ############# ### ############# #
# # #     #   #   # # #       #       #   # #     #     # #
# ### ####### ### # # ####### # ##### ### # # # ### ### # #
#   #         #   # #   #   #   # #   #   # # # #   # # # #
### # ####### # ### ### # ####### # ### # # # # # # # # # #
#   #       # #   # #   #   #     #   # #   # # # # #   # #
# ######### ##### # # ##### # # ##### # ##### ### # # ### #
# #     #     #     # #   # # #       # #         # # #   #
# # ### ##### # ##### # # # # ######### # ######### # # ###
#   #         # # #   # # #     #       #   #   #   # # # #
##### ### ##### # # ##### ####### ######### # # # ### # # #
#   # #   #   #   # #       #   #   #   #   # #   # # # # #
### # # ##### ##### # # ##### # ### ### # ######### # # # #
#   # #       #   # # # #     #     #     #     #     #   #
# # # ######### # # # ### ######### # ##### ### # #########
# # #       #   # # #     #     #   # #     # # # #       #
# ### ##### # ### # # ##### ### # ### ##### # # # # ##### #
#   # #     # # #   # #     #   #   #     #   #   # #   # #
### # # ##### # ##### # ##### # ### ##### ### ##### # ### #
#   # # #   # #     # # #     #   #     # # #   #   #   # #
# ### ### # # ##### # # ######### ##### # # # ### ##### # #
#   #   # #         #   #     #       # #   #     #   # # #
# # ### # # ####### ### # ### ####### # ########### # # # #
# #   # # # #   #   # # # #   #     # #   #         # #   #
# ### # # ### # # ### # # # ### ### ##### # ######### # ###
#   #   #     # #     # # # #   # #       #       #   #   #
### ########### ##### # # # # ### ##### ######### ####### #
# #     #     # #   # # # # #   #     # #                 #
# ##### ##### # # # ### # ##### # ### ### #################
#     #       # # #     # #     # # #   #               # #
# # ######### # # ##### # # ##### # ### # ########### # # #
# # #         #   # #   # #       #   # # #   #     # #   #
### # ############# # ### ########### # # # # # ##### #####
#   # #                   #           #   # # # #   #     #
# ### # ### ############# ### # ##### ##### # # # # ##### #
#     # #   #   #       #     # #   # #     # # # #       #
####### # ### # # ############### # # # ##### # # ##### ###
#   # # #   # # #     #     #   # # # #   #     # #   #   #
### # # ### # ####### # ### # # # # # ### ####### # # ### #
#     #   # # #     #     # # # # # #   #   #   #   #   # #
# ####### # # # ### ##### ### # # # ##### # # ######### ###
# #     # # # # #       #     # # #       # #             #
# # # ### # # # ########### ### # ### ##### ############# #
#   #     #   #               #   #       #               #
####################### ###################################
