######### ###########
#   #   #   #     # #
# ### # # # # ### # #
#     #   #   #   # #
##### # ####### ### #
#   # # #     #     #
# # ### ##### ##### #
# #   # #     #     #
# ### # # # ### #####
# #     # #   #     #
### ##### ######### #
#   #   #           #
# ##### #############
#       #       #   #
### ### # ##### # # #
# #   # #     #   # #
# ### ########### # #
#   #           # # #
# # ####### ### ### #
# #           #     #
##### ###############
